0,2,X,0,0
0,X,0,0,0
4,0,0,X,5
X,0,5,3,0
4,0,0,X,X