0,0,X,0,X
0,X,2,3,0
0,3,X,0,0
X,0,0,0,4
5,0,X,0,3