X,0,0,0,5
4,0,0,0,4
X,0,0,0,X
2,0,0,0,0
X,0,X,4,0