3,0,4,0,5
0,0,0,0,0
X,0,0,0,0
0,0,X,0,0
2,X,0,0,X