4,0,0,3,0
X,0,0,0,X
0,0,0,0,0
0,0,0,0,0
0,3,0,X,0