X,5,0,3,0
0,3,0,0,X
0,0,0,X,0
0,X,4,0,0
3,0,X,2,X